1 11 31
###############################
#p *************   *  * *f*   #
# # # # # # # # # # # #*#*#*# #
#  *************      *   * * #
# # # # # # # # #*#*#b# # # #*#
#  ************* *  *         #
# # # # # # # # # #*# #*# # # #
#  ************* *   *        #
# # # # # # # # # #*#*# # # # #
#x *************      *   * *x#
###############################