1 11 31
###############################
#p  #    * *#* * * *#* *f*    #
#* *#* *#   # 5 # 5 #   #  *  #
#   # 4 # 4 #   #   #   #  6  #
# # # # # # # # #*#*#b# # # #*#
#  *#* *#* *#* *#*  #   #  6  #
# # # # # # # # # #*# #*# # # #
# 6*#* *#* *#* *#*  #*  #     #
# # # # # # # # # #*#*# # # # #
#s * * *#* * * *#     * # * *x#
###############################